NO ./Sprites/walls/wallG0.xpm
SO ./Sprites/walls/wallG0.xpm
WE ./Sprites/walls/wallG1.xpm
EA ./Sprites/walls/wallG1.xpm

F 60,39,41
C 142,28,28

        1111111111111111111111111
        1000000000100000000S00001
        1000000000101110000000001
        1001110000000000000000001
        1000000000100000000000001
        1000000000100000011111001
11111111101000000000000011000000011111111111111111111111111
10110001110000010000000000011000111000001000000000000010001
10000000001000000000000000000000000100000000000000011011101
10000000001000000001100000000000000100000000110000000010001
10000000001000000111000000000000000100000011100000000010001
10000000001000000000000000000000000100000000000000000010001
10000000001000000000000100000000000100000000000010000010001
10000000000000000110000000000000000000000011000000000010001
11111111100100000000000001100000011111111111111111111111111
        1000000000100000000001001
        1011000001110001000111111
        1111100000000000000011111
        1111110000000000000111111
        1111110000000000000111111
        1111110000000000000111111
        1111111000000000001111111
        1111111000000000001111111
        1111111100000000011111111
        1111111100000000011111111
        1111111100000000011111111
        1111111110000000111111111
        1111111110000000111111111
        1111111110000000111111111
        1111111110000000111111111
        1111111110000000111111111
        1111111110000000111111111
        1111111110000000111111111
        1111111100000000011111111
        1111111100000000011111111
        1111111100000000011111111
        1111111000000000001111111
        1111111000000000001111111
        1111110000000000000111111
        1111110000000000000111111
        1111100000000000000011111
11111111111110000000000000001111111111111111
10000000001100000000000000000111100000000001
10011111110000000000000000000000011111111001
10010011000000000000000000000000000011000001
10100100000000000000000000000000000000100101
10001000000000000000000000000000000000010001
10001000000000000000000000000000000000010001
101100000000000000000B0000000000000000001101
10110000000000000000000000000000000000001101
11110000000000000000000000000000000000001111
11111111111111111111111111111111111111111111