F 13,8,41
NO            ./Sprites/bluestone.xpm
SO 		./Sprites/redstone.xpm
WE          		            ./Sprites/greenstone.xpm
C          		              255,255,255
EA ./Sprites/yellowstone.xpm


        1111111111111111111111111
        1000000000100000000000001
        1011000001110000000000001
        1001000000100000000000001
111111111011000001110000000000001
100000000011000001111101111111111
11111111111011011100000010001
11110111111011111101010010001
11000000110101011100000010001
10000000100000001100000010001
10000000100000000001010000001
11000001110101011111011110S0111
11110111 1110101 101111010001
11111111 1111111 111111111111