NO ./Sprites/bluestone.xpm
SO ./Sprites/eagle.xpm
WE ./Sprites/greystone.xpm
EA ./Sprites/redbrick.xpm

F 220,100,0
C 225,30,0

        1111111111111111111111111
        1000000000100000000000001
        1011000001110001000000001
        100100000010001 100N00001
111111111011000001110001000000001
100000000011000001111101111111111
11111111111011011100000010001
11110111111011111101010010001
11000000110101011100000010001
10000000100000001100000010001
10000000100000000001010000001
1100000111010101111101111000111
11110111 1110101 101111010001
11111111 1111111 111111111111