NO ./Sprites/walls/wallG0.xpm
SO ./Sprites/walls/wallG0.xpm
WE ./Sprites/walls/wallG1.xpm
EA ./Sprites/walls/wallG1.xpm

F 60,39,41
C 142,28,28

        1111111111111111111111111
        1000000000100000000B00001
        1011000001110001000000001
        100100000010001 100000001
111111111011000001110001000N00001
100000000011000001111101111111111
11111111111011011100000010001
11110111111011111101010010001
11000000110101011100000010001
10000000100000001100000010001
10000000100000000001010000001
1100000111010101111101111000111
11110111 1110101 101111010001
11111111 1111111 111111111111