NO ./Sprites/walls/wallG0.xpm
SO ./Sprites/walls/wallG0.xpm
WE ./Sprites/walls/wallG1.xpm
EA ./Sprites/walls/wallG1.xpm

F 60,39,41
C 142,28,28

11111111111111111111111111111111111111111111111111
10000000000000001100001000100010000010001110000011
10010101000000000000000010001000100000000101000001
10100000101000001000001010000000000111100010001011
10100100000010010000101000000000110000000000100011
1000001001010001100S000010000000010011010100100001
10100000000000000000010010011001000100110010000001
10001100100000000000000000100001000000000000000001
10110000000010000010100010100000100101000000011111
10000000000100100000000001100000000001000111111011
11000000000000010000000000000010100001011110000001
10100011100010100000100000110000000000001000000101
10000000100010000010100001001100100000001000001001
10001101000100001101000001010000010000001000000011
10000110000000000000010110100000001100001000000001
10000000000010001000001001000000000000101101010001
11000010010000000010000000100001000010000100000001
11111111111110111111111111111111111111111100000001
11110011111110111111000100100000000001011100000101
10011110000000000001111100111000011111110001000111
10000001100001010100000000101111010100000000000001
11110001000000000101100000001001000000000000010101
10000000000000000000000000000000000000000000000011
10000000000000000000000000000000000000000000000111
10001000010000000B00000010000000000000100000000001
10000000000000000000000000000000000000000000001001
10000000000000100001010001000001000000100100000011
11111111111111111111111111111111111111111111111111