NO ./Sprites/bluestone.xpm
SO ./Sprites/eagle.xpm
WE ./Sprites/greystone.xpm
EA ./Sprites/redbrick.xpm

F 13,8,41
C 102,8,8

11111111111111111111111111111111
1S000000000000000000000000000001
10000000000000000000000000000001
10000000000000000000000000000001
10000000000000000000000000000001
10000000000000000000000000000001
10000000000000000000000000000001
10000000000000000000000000000001
10000000000000000000000000000001
10000000000000000000000000000001
10000000000000000000000000000001
11111111110000000000000000000001
10000000010000000000000000000001
10000000010000000000000000000001
10000000010000000000000000000001
10000000010000000000000000000001
10000000010000000000000000000001
10000000010000000000000000000001
10000000010000000000000000000001
10000000010000000000000000000001
10000000011111111000000000000001
10000000000000001000000000000001
10000000000000001000000000000001
10000000000000001000000000000001
10000000000000001000000000000001
10000000000000001000000000000001
10000000000000001000000000000001
10000000000000001000000000000001
10000000000000001000000000000001
10000000000000001000000000000001
10000000000000001000000000000001
10000000000000001000000000000001
11111111111111111111111111111111